apple - jabłko
cat - kot
dog - pies
house - dom
computer - komputer
table - stół
chair - krzesło
friend - przyjaciel
book - książka
car - samochód
city - miasto
water - woda
music - muzyka
movie - film
school - szkoła
language - język
family - rodzina
garden - ogród
phone - telefon
game - gra
coffee - kawa
work - praca
smile - uśmiech
time - czas
sun - słońce
moon - księżyc
breakfast - śniadanie
dinner - obiad
lunch - lunch
friend - przyjaciel
love - miłość
beach - plaża
tree - drzewo
flower - kwiat
city - miasto
country - kraj
world - świat
school - szkoła
teacher - nauczyciel
student - uczeń
university - uniwersytet
office - biuro
home - dom
apartment - mieszkanie
street - ulica
bus - autobus
train - pociąg
plane - samolot
restaurant - restauracja
hotel - hotel
park - park
mountain - góra
river - rzeka
lake - jezioro
bridge - most
road - droga
shop - sklep
market - rynek
supermarket - supermarket
museum - muzeum
art - sztuka
science - nauka
history - historia
geography - geografia
math - matematyka
biology - biologia
chemistry - chemia
physics - fizyka
language - język
English - angielski
Spanish - hiszpański
French - francuski
German - niemiecki
Chinese - chiński
Japanese - japoński
Italian - włoski
Russian - rosyjski
Arabic - arabski
Portuguese - portugalski
Dutch - holenderski
music - muzyka
rock - rock
pop - pop
classical - klasyczna
jazz - jazz
country - country
hip hop - hip hop
dance - taniec
sport - sport
football - piłka nożna
basketball - koszykówka
tennis - tenis
swimming - pływanie
cycling - kolarstwo
running - bieganie
skiing - narciarstwo
yoga - joga
cooking - gotowanie
painting - malowanie
travel - podróżować - tak wyglądają fiszki